print """
#        #         #         #
 #      # #       #          #
  #     #  #     #           #
   #   #    #   #            #
    # #      # #             #
     #        #              ###########
"""


print """
  #############################
  ###  #################    ###
  ##     ###############    ###  
  ####      ################### 
  ######       ################  
  ########       ##############
  ##########        ###########
  ############         ########
  ###############         #####
  ###    ###########        ###
  ###    #############     ####
  #############################
  """
