print "

##        ##        ##         ##
 ##      ####      ##          ##
  ##    ##  ##    ##           ##
   ##  ##    ##  ##            ## 
    ####      ####             ##
     ##        ##              ###########
 " 
  
  
  
  
  
  
  
  
  
  
  
